R 167777770 155555555560

NO textures/purplestone.xpm
SO textures/wood.xpm
WE textures/eagle.xpm
EA textures/redbrick.xpm

S textures/barrel.xpm

C 0,0,255
F 0,153,0


1111111111
1010101011
11E0000001
1111111111

